333333333333333
300110101111003
303131313131303
301111111111103
313131313131313
311111111101113
313130313131313
311111011111113
313131313131313
301101111011103
303131313131303
300111111011003
333333333333333
